{
    "樑": "梁",
    "污": "汙",
    "濕": "溼",
    "雇": "僱",
    "台": "臺",
    "墬": "墜",
    "羣": "群",
    "峯": "峰",
    "嘞": "勒",
    "啓": "啟",
    "枱": "檯",
    "羡": "羨",
    "蹪": "蹟",
    "舘": "館",
    "暪": "瞞",
    "裏": "裡",
    "飇": "飆",
    "劵": "券",
    "嬷": "媽",
    "慪": "嘔",
    "妳": "你",
    "祢": "你",
    "她": "他",
    "它": "他",
    "祂": "他",
    "牠": "他",
    "耪": "膀",
    "玆": "茲",
    "壆": "學",
    "艄": "艘",
    "絶": "絕",
    "爲": "為",
    "廻": "迴",
    "内": "內",
    "猪": "豬",
    "奬": "獎",
    "壐": "璽",
    "捓": "邪",
    "喽": "咯",
    "刂": "刀",
    "桖": "恤",
    "诶": "欸",
    "慽": "戚",
    "ㄟ": "欸",
    "没": "沒",
    "巄": "攏",
    "搂": "摟",
    "歳": "歲",
    "涙": "淚",
    "别": "別",
    "隣": "鄰",
    "麽": "麼",
    "瞜": "囉",
    "俢": "修",
    "昰": "是",
    "抛": "拋",
    "醶": "鹼",
    "譨": "能",
    "颤": "顫",
    "柂": "拖",
    "儍": "傻",
    "ㄧ": "一",
    "乁": "欸",
    "着": "著",
    "复": "復",
    "駔": "組",
    "郷": "鄉",
    "秃": "禿",
    "聴": "聽",
    "硑": "研",
    "鼔": "鼓",
    "髪": "髮",
    "煿": "博",
    "絻": "絕",
    "谁": "誰",
    "躜": "躦",
    "铝": "鋁",
    "抺": "抹",
    "綘": "縫",
    "稐": "倫",
    "捣": "搗",
    "淂": "得",
    "圏": "圈",
    "衞": "衛",
    "网": "網",
    "篹": "算",
    "吴": "吳",
    "铣": "銑",
    "咘": "噗",
    "躰": "體",
    "廰": "廳",
    "凯": "凱",
    "鈎": "鉤",
    "閲": "閱",
    "携": "攜",
    "叠": "疊",
    "届": "屆",
    "聼": "聽",
    "愗": "某",
    "綳": "繃",
    "鈡": "鐘",
    "儅": "當",
    "净": "淨",
    "脚": "腳",
    "訧": "就",
    "嵗": "歲",
    "缪": "繆",
    "来": "來",
    "厰": "廠",
    "衆": "眾",
    "綫": "線",
    "説": "說",
    "厨": "廚",
    "温": "溫",
    "関": "關",
    "濶": "闊",
    "彚": "彙",
    "灯": "燈",
    "囯": "國",
    "凴": "憑",
    "鷄": "雞",
    "纳": "納",
    "纎": "纖",
    "擧": "舉",
    "縂": "總",
    "强": "強",
    "参": "參",
    "檫": "擦",
    "鲎": "鱟",
    "佢": "倨",
    "瓩": "千瓦",
    "Α": "A",
    "Β": "B",
    "Ε": "E",
    "Η": "H",
    "Ι": "I",
    "Κ": "K",
    "Μ": "M",
    "Ν": "N",
    "Ρ": "P",
    "Τ": "T",
    "Χ": "X"
}